1  1 1 1 1 1
1  2 2 2 1 1
11 0 0 0 1 1
32 1 W 1 9 1
1  1 0 0 1 1
1  1 1 1 1 1