1 1 1 1 1 1 1
1 0 0 0 P 0 1
1 0 1 0 P 0 1
P 0 1 0 0 0 1
1 0 P P 0 0 1
1 0 0 0 0 0 1
1 0 0 0 0 1 1
P 0 0 0 0 P 1
1 0 0 0 0 P 1
P P 0 0 W 0 1
1 1 P P 1 P 1